#####.#####
#.........#
#.#######.#
#.#######.#
#.#######.#
..#######..
#.#######.#
#.#######.#
#.#######.#
#.........#
#####.#####