#.#########
#......####
#......+.##
#......#.##
##+#####.##
...#####...
########.##
########.##
#........##
..###.#####
#.###.#####