#.###.#####
#.#.+.#####
#.#.#.#####
#...#.#####
#####.#####
...........
#####.#####
#####.#...#
#####.#.#.#
#####.+.#.#
#####.###.#