#####.#####
#.........#
#.       .#
#.       .#
#.  ###  .#
..  ###  ..
#.  ###  .#
#.       .#
#.       .#
#.........#
#####.#####