#####.#####
#####+#####
#.........#
#.........#
#||||+||||#
...........
#####.#####
#####.#####
#####.#####
#####.#####
#####.#####