#####.#####
#...#.#...#
#...+.+...#
#...#.#...#
#|||#.#|||#
...........
#|||#.#|||#
#...#.#...#
#...+.+...#
#...#.#...#
#####.#####