#.###.#####
#.###.....#
#.#######.#
#.+.....-.#
###.....-.#
..#.....-..
#.#.....-.#
#.#.....-.#
#.###+###.#
#.........#
#####.#####