#####.#####
#.........#
#.###.###.#
#.-.#.#.-.#
#.-.#.#.-.#
..-.+.+.-.#
#.-.#.#.-.#
#.-.#.#.-.#
#.###.###.#
#.........#
#####.#####