#####.#####
#.........#
#.~~~.~~~.#
#.~~~.~~~.#
#.~~...~~.#
.....*.....
#.~~...~~.#
#.~~~.~~~.#
#.~~~.~~~.#
#.........#
#####.#####