#####.#####
#~~~~.~~~~#
#~.......~#
#~.~~~~~.~#
#~.~~~~~.~#
...~~~~~...
#~.~~~~~.~#
#~.~~~~~.~#
#~.......~#
#~~~~.~~~~#
#####.#####