#####.#####
#~~~~.~~~~#
#~~~~.~~~~#
#~~~~.~~~~#
#~~~~.~~~~#
...........
#~~~~.~~~~#
#~~~~.~~~~#
#~~~~.~~~~#
#~~~~.~~~~#
#####.#####