#####.#####
#####.#####
#####+#####
###.....###
###.   .###
..+.   .+..
###.   .###
###.....###
#####+#####
#####.#####
#####.#####