#####.#####
#####.#####
#####.#####
###.....###
###.   .###
....   ....
###.   .###
###.....###
#####.#####
#####.#####
#####.#####