#####.#####
#~~~-.-~~~#
#~###.###~#
#~###.###~#
#|###.###|#
...........
#|###.###|#
#~###.###~#
#~###.###~#
#~~~-.-~~~#
#####.#####