#####.###.#
#####.+...#
#####.#####
#####.#####
#####.#....
......+....
#####.#....
#####.#####
#####.#####
#####.+...#
#####.###.#