####~.~####
####~.~####
####~.~####
####~.~####
~~~~~.~~~~~
...........
~~~~~.~~~~~
####~.~####
####~.~####
####~.~####
####~.~####