#####.#####
#.........#
#.~~~.~~~.#
#.~$$:$$~.#
#.~$:::$~.#
...::>::...
#.~$:::$~.#
#.~$$:$$~.#
#.~~~.~~~.#
#.........#
#####.#####