####...####
####...####
####...####
#####+#####
...##.##...
...+...+...
...##.##...
#####+#####
####...####
####...####
####...####