#####.#####
#####+#####
##.......##
##.......##
##.......##
.+.......+.
##.......##
##.......##
##.......##
##.......##
##.......##