#####.#####
#.....#...#
#.#####...#
#.#####...#
#.######+##
...........
#.######+##
#.#####...#
#.#####...#
#.....#...#
#####.#####