...........
.#|||||||#.
.-       -.
.-       -.
.-       -.
.-       -.
.-       -.
.-       -.
.-       -.
.#|||||||#.
...........