#####.#####
#####.#####
##....   ##
##.      ##
##.      ##
...........
##      .##
##      .##
##   ....##
#####.#####
#####.#####