#####.#####
#####+#####
##....   ##
##.      ##
##.      ##
.+.......+.
##      .##
##      .##
##   ....##
#####+#####
#####.#####