#####.#####
#.........#
#.........#
#..#...#..#
#.........#
...........
#.........#
#..#...#..#
#.........#
#.........#
#####.#####