#####.#####
#####.#####
#####.#####
#.....#####
#.#########
..######...
#...####.##
###.###..##
###.###.###
###.....###
#####.#####