#####.#####
####...####
####...####
####...####
#.........#
.....#.....
#.........#
####...####
####...####
####...####
#####.#####