#####.###.#
#.....###..
#.#######+#
#.........#
#########.#
...........
#########.#
#.........#
#.#######+#
#.....###..
#####.###.#