#.###.###.#
....#.#....
#...#+#...#
#.........#
###.   .###
..+.   .+..
###.   .###
#.........#
#...#+#...#
....#.#....
#.###.###.#