#.###.###.#
..+.#.###..
###.#.###+#
###.#.....#
###.#.#####
...........
#####.#.###
#.....#.###
#+###.#.###
..###.#.+..
#.###.###.#